{
	"bricks": [
	  "-----X-X-X-X-----",
	  "---X---------X---",
	  "---XX-X---X-XX---",
	  "--------g--------",
	  "---X---XoX---X---",
	  "-----X--b--X-----",
	  "--------G--------",
	  "-----X--r--X-----",
	  "-------XBX-------",
	  "--------p--------",
	  "---XX-X---X-XX---",
	  "---X---------X---",
	  "-----X-X-XpX-----",
	  "-----------------",
	  "-----------------",
	  "-----------------"
	],
	"background": 0,
	"name": "stage 8",
	"next": "stage9",
	"type": "level"
  }